1 1 1 1 1 1 1 1 1 1 1 1 1 1 1 1 1 1
1 0 0 3 1 0 0 0 1 0 0 0 0 1 6 0 0 1
1 0 1 1 1 1 1 0 1 0 1 1 1 1 1 1 0 1
1 0 0 0 0 0 1 0 0 0 1 0 0 0 8 1 0 1
1 0 1 0 1 1 1 0 1 0 1 0 1 1 1 1 0 1
1 0 1 0 1 0 0 0 1 0 1 0 1 0 0 0 0 1
1 10 1 0 1 7 1 0 1 0 0 0 1 0 1 0 1 1
1 1 1 0 1 1 1 0 1 1 1 0 1 0 1 0 0 2
1 0 0 0 0 0 1 0 1 0 1 1 1 0 1 1 1 1
1 0 1 1 1 1 1 0 1 0 0 9 1 0 1 0 0 1
1 0 1 0 0 0 1 0 0 0 1 1 1 0 1 1 0 1
1 0 1 0 1 1 1 0 1 0 1 0 1 0 0 0 0 1
1 0 0 0 1 0 0 0 1 0 1 0 1 1 1 1 0 1
1 1 1 0 1 0 1 0 1 0 0 0 0 0 11 1 0 1
1 5 1 0 0 0 1 0 1 0 1 1 1 0 1 1 0 1
1 0 0 0 1 0 1 0 1 0 4 1 0 0 0 0 0 1
1 1 1 1 1 1 1 1 1 1 1 1 1 1 1 1 1 1

